############
#S.........#
#.####.###.#
#.#....#...#
#.#.##.#.#.#
#.#..#...#.#
#.##.###.#.#
#....#...#.#
#.####.#.#.#
#......#G..#
############
