################
#S.............#
#.############.#
#.#..........#.#
#.#.########.#.#
#.#.#......#.#.#
#...#.####.#...#
###.#.#..#.#.###
#...#.#..#.#...#
#.###.####.###.#
#..............#
#.############G#
################
