############
#S.........#
#.####.###.#
#....#...#.#
###.##.#.#.#
#...#..#...#
#.###.####.#
#.....#....#
#.#####.##.#
#.......#G.#
############
