############
#S.........#
#.########.#
#........#.#
#.######.#.#
#......#.#.#
#.####...G.#
############
