##############
#S...........#
#.##########.#
#.#........#.#
#.#.######.#.#
#.#.#....#.#.#
#.#.#.##.#.#.#
#.#.#....#.#.#
#.#.######.#.#
#.#........#.#
#.##########.#
#..........#.#
##########.#G#
##############
