############
#S.........#
#.########.#
#.#......#.#
#.#.####.#.#
#.#.#..#.#.#
#.#.#..#.#.#
#.#.####.#.#
#.#......#.#
#.########.#
#.........G#
############
