############
#S..#......#
###.#.####.#
#...#.#....#
#.###.#.##.#
#.....#..#.#
#.#####..#.#
#.......#..#
#.#######.##
#.........G#
############
