############
#S.........#
#.####.....#
#....#.....#
#.##.#.##..#
#....#..#..#
#.###...#..#
#.....#..G.#
############
